9
OWwOWWWWW
WwOWW X W
WOWW  X W
OWW     W
WW    WWW
W    WWOO
WXX WWWWO
W   WWWOW
WWWWWOWWO
4
2 5
3 4
4 3
5 2
4 4